01_01_01_01_01_01_00_01
01_11_00_00_01_00_00_00
01_00_01_00_01_00_01_00
00_00_01_00_00_00_01_00
01_00_01_01_00_01_01_00
01_00_00_00_01_00_00_00
01_00_01_00_00_00_10_01
00_00_00_00_01_01_01_01
01_10_01_10_00_01_00_01 //start (6,6) end (1,1)