01_01_01_01_01_01_00_01
01_10_00_00_01_00_00_00
01_00_01_00_01_00_01_00
00_00_01_00_00_00_01_00
01_00_01_01_00_01_01_00
01_00_00_00_01_00_00_00
01_00_01_00_00_00_11_01
00_00_00_00_01_01_01_01
00_01_00_01_01_10_01_10 //start (1,1) end (6,6)